111111111111111111
10N1C0000000C10001
1P01111110111101E1
10C000000000C00111
111111111111111111
