111111111111111111
1001C0000000C10001
1P01111110111101E1
10C000000000000111
111111111111111111
