111111111111111111111
1C000001CP00100000001
100NC0011110101001101
1000C0000010101001101
100C0001CC1C001001101
10000N0100111110011E1
100000C100000000N1111
111111111111111111111
