111111111111111111111
1C000N01C000100000001
1000C0011110101001101
1000N0000010101001101
100C0001CC1C001001101
100000010N111110011E1
1P0000C10000000001111
111111111111111111111
